##########A#######
##########A#######
##########A#######
##########A#######
AAAAAAA###A#######
######A###A#######
######A###A#######
######A##AA#######
######A##A########
######AAAA########
########A#########
########A#########
########A#########
########A#########
#######AAA########
