##########A#######
##########A#######
##########A#######
##########A#######
AAAAAAA###AAAAAA##
######A########A##
######A########A##
######A##AAAA##A##
######A##A##A##A##
######AAAA##A##A##
########A###A##A##
########A###A##A##
########A###AAAA##
########A#########
#######AAA########
